# Special countries..
REB = "countries/Rebels.txt"
PIR = "countries/Pirates.txt"
NAT = "countries/Natives.txt"

#kingdom of Kyath
KYA = "countries/Kyath.txt"
IWE = "countries/Iwenlumy.txt"
KYT = "countries/Kyatlasian Theocracy.txt"
ANO = "countries/Anores.txt"
TIT = "countries/Titar.txt"
MAT = "countries/Matnolu.txt"
LUR = "countries/Lurt.txt"
IHA = "countries/Ihadar.txt"
ELE = "countries/Elesilon.txt"
LEL = "countries/Leleth.txt"
NIL = "countries/Nilaurhalin.txt"
PAR = "countries/Parhama.txt"
YRA = "countries/Yransa.txt"
OAY = "countries/Oayvein.txt"
OFL = "countries/Oflorhan.txt"
ERI = "countries/Eritys.txt"
ESH = "countries/Eshyr.txt"
MEN = "countries/Menor.txt"
ADR = "countries/Adralas.txt"
CYU = "countries/Cyueg.txt"
NAD = "countries/Nadara.txt"
SHE = "countries/Shemsele.txt"
SAL = "countries/Salor.txt"
MNH = "countries/Menatheas.txt"
RAU = "countries/Rauthyr.txt"
NEL = "countries/Nelsyari.txt"
KAF = "countries/Kafethyr.txt"
NYH = "countries/Nyhenat.txt"
OLH = "countries/Olhoreireelu.txt"
KEA = "countries/Keathene.txt"
UNO = "countries/Unolad.txt"
DRE = "countries/Drelnora.txt"
ONE = "countries/Onebelho.txt"
DRG = "countries/Dreghei.txt"
RYA = "countries/Ryamyueg.txt"
BER = "countries/Beriksarya.txt"
BOL = "countries/Boluroya.txt"
BEY = "countries/Beycu.txt"
ATH = "countries/Athanila.txt"
INZ = "countries/Inzedia.txt"
BAT = "countries/Batvin.txt"
NFA = "countries/Nfanatha.txt"
ZIY = "countries/Ziyalap.txt"
BAY = "countries/Bayparya.txt"
DOU = "countries/Douan.txt"
REY = "countries/Reylanlya.txt"
BES = "countries/Beshek.txt"
UMA = "countries/Umalesy.txt"
MTN = "countries/Matn.txt"
RAM = "countries/Rauma.txt"
ISE = "countries/Isesiralne.txt"
SOH = "countries/Sohoremyfa.txt"
GUL = "countries/Gulba.txt"
YER = "countries/Yerina.txt"
KIZ = "countries/Kizipru.txt"
GRU = "countries/Grur.txt"
BOZ = "countries/Bozred.txt"
AKM = "countries/Akmaka.txt"
MTE = "countries/Mathei.txt"
MYH = "countries/Mythar.txt"
CHA = "countries/Chaun.txt"
FRY = "countries/Freyglen.txt"
TOP = "countries/Topika.txt"
GUG = "countries/Gugh.txt"
VER = "countries/Veririk.txt"
FRS = "countries/Free shires.txt"
MOO = "countries/Moonewick.txt"
GRA = "countries/Grashearde.txt"
PIC = "countries/Piceden.txt"
LIT = "countries/Litvault.txt"
LAD = "countries/Ladowvault.txt"
IND = "countries/Indoranas.txt"

LIR = "countries/Liretlet.txt"
FAN = "countries/Fanilnemyel.txt"
SHU = "countries/Shaumanyn.txt"
NTH = "countries/Nathion.txt"
THI = "countries/Thilmaren.txt"
ASF = "countries/Asfereth.txt"
CEL = "countries/Celulil.txt"
SIN = "countries/Sineri.txt"
BRI = "countries/Bririon.txt"
THL = "countries/Thilrana.txt"

ILR = "countries/Ilrazin.txt"
WAS = "countries/Wassad.txt"
OLL = "countries/Ollunenodora.txt"
DRA = "countries/Draumyuer.txt"
HET = "countries/Heth.txt"
KET = "countries/Kethas.txt"
EAN = "countries/Eanorla.txt"

ANT = "countries/Anthyr.txt"

HLR = "countries/Vulikivian Empire.txt"
VUL = "countries/Vulikiv.txt"
PAA = "countries/Paarhan.txt"
KHA = "countries/Khamar.txt"
PRA = "countries/Pranax.txt"
SHA = "countries/Shamorgath.txt"
ESX = "countries/Esxar.txt"
KAM = "countries/Kamor.txt"
KEM = "countries/Kemor.txt"
XAL = "countries/Xalor.txt"
TER = "countries/Termina.txt"
VII = "countries/Viindararyn.txt"
SUS = "countries/Susmemero.txt"
GAR = "countries/Garumor.txt"
DEM = "countries/Demina.txt"
LOR = "countries/Lorla.txt"
TEN = "countries/Tenub.txt"
SEM = "countries/Semiol.txt"
WIS = "countries/Wismo.txt"
SAA = "countries/Saassano.txt"
PUL = "countries/Pulora.txt"
KMO = "countries/Kemoina.txt"
HUR = "countries/Huras.txt"
TEI = "countries/Teris.txt"
PER = "countries/Perimia.txt"
TRN = "countries/Terisnor.txt"
KER = "countries/Kerandarayn.txt"
TSE = "countries/Tsenla.txt"

CAL = "countries/Calgorwic.txt"
GHA = "countries/Ghand.txt"
MAL = "countries/Malricandadros.txt"
ACH = "countries/Achtendenvaldoch.txt"
VAR = "countries/Varchsenwind.txt"
DUD = "countries/Dukkikkukdid.txt"
LAU = "countries/Laughei.txt"
EHT = "countries/Eshdenhettentarloct.txt"
BEC = "countries/Bechshartnecargen.txt"
ULR = "countries/Ulracctrancrarlot.txt"
VRT = "countries/Vartenlotch.txt"
TOR = "countries/Torluok.txt"
AHN = "countries/Achnirvachthrch.txt"
MAR = "countries/Marvorvincalintir.txt"
FAE = "countries/Faelochlor.txt"
TAE = "countries/Taelautchtin.txt"



PAP = "countries/Yulikivian.txt"